  ####              
  #..#     #######  
  #..#     #.....#  
  #..#######.....#  
  #..............#  
  #..#######.....#  
  ####     #....O#  
           #######  