  ##########        
  #O.......#######  
  #..####........#  
  #..#######.....#  
  #..............#  
  #..#######.....#  
  ####     #.....#  
           #######  